20 15
####################
#S H    £       H  #
#  H  ######    H  #
#  HHH     #    H  #
#      #   #    H  #
# #####H####    H  #
#      H   £    H  #
# £    H--------   #
#      H           #
# ######   £       #
#      HHHHHHHH    #
# ####         #   #
#    £      £  #   #
# HHHHHHHHHHHH     #
####################